{
	
	"numberOfRandomlyPositionedAnimals" : 5,

	"world" : [
		[
			"00000000000000000000",
			"00000000000000000000",
			"00111111111111111100",
			"00111111111111111100",
			"00111111111111111100",
			"00111111111111111100",
			"00133311111111111100",
			"00133311111111111100",
			"00111111112211111100",
			"00111111122221111100",
			"00111111222222111100",
			"00111111222222111100",
			"00111111122221111100",
			"00111111112211111100",
			"00111111111111111100",
			"00111111111111111100",
			"00111111111111111100",
			"00111111111111111100",
			"00000000000000000000",
			"00000000000000000000"
		],
		[
			"00000000000000000000",
			"00000000000000000000",
			"00111111111111111100",
			"0010p000000000000100",
			"00100000000000010100",
			"00111111110000000100",
			"00100000000000000100",
			"00100000000111111100",
			"00100000000000000100",
			"00110000000000000100",
			"001000000a0000000100",
			"00100001000000000100",
			"00100000000100000100",
			"00100000000000000100",
			"00100100000000000100",
			"001000000000000g0100",
			"00100100000000000100",
			"00111111111111111100",
			"00000000000000000000",
			"00000000000100000000"
		],
		[
			"00000000000000000000",
			"00000000000000000000",
			"00000000000000000000",
			"00000000000000000000",
			"00000000000000000000",
			"00000000000000000000",
			"00000000000000000000",
			"00000000000000000000",
			"00000000000000000000",
			"00000000000000000000",
			"00000000000000000000",
			"00000000000000000000",
			"00000000000000000000",
			"00000000000000000000",
			"00000000000000000000",
			"00000000000000000000",
			"00000000000000000000",
			"00000000000000000000",
			"00000000000000000000",
			"00000000000000000000"
		],
		[
			"00000000000000000000",
			"00000000000000000000",
			"00000000000000000000",
			"00000000000000000000",
			"00000000000000000000",
			"00000000000000000000",
			"00000000000000000000",
			"00000000000000000000",
			"00000000000000000000",
			"00000000000000000000",
			"00000000000000000000",
			"00000000000000000000",
			"00000000000000000000",
			"00000000000000000000",
			"00000000000000000000",
			"00000000000000000000",
			"00000000000000000000",
			"00000000000000000000",
			"00000000000000000000",
			"00000000000000000000"
		]
	]
}