{
	"world" : [
		[
			"00000000000000000000",
			"00000000000000000000",
			"00112222211111111100",
			"00111111111111111100",
			"00111111111111111100",
			"00111111111111111100",
			"00111111111111111100",
			"00111111111111111100",
			"00111111111111111100",
			"00111111111111111100",
			"00111111111111111100",
			"00111111111111111100",
			"00111111111111111100",
			"00111111111111111100",
			"00111111111111111100",
			"00111111111111111100",
			"00111111111111111100",
			"00111111111111111100",
			"00000000000000000000",
			"00000000000000000000"
		],
		[
			"00000000000000000000",
			"00000000000000000000",
			"00000010000000000000",
			"0000p000000000000000",
			"00000000000000010000",
			"00000000000000000000",
			"00000000000000000000",
			"00000000000100000000",
			"00000000000000000000",
			"00010000000000000000",
			"00000000000000000000",
			"00000000000000000000",
			"00000000000100000000",
			"00000000000000000000",
			"00000000000000000000",
			"000000000000000g0000",
			"00000100000000000000",
			"00000000000000100000",
			"00000000000000000000",
			"00000000000100000000"
		],
		[
			"00000000000000000000",
			"00000000000000000000",
			"00000000000000000000",
			"00000000000000000000",
			"00000000000000000000",
			"00000000000000000000",
			"00000000000000000000",
			"00000000000000000000",
			"00000000000000000000",
			"00000000000100000000",
			"00000000000000000000",
			"00000000000000000000",
			"00000000000000000000",
			"00000000001000000000",
			"00000000000000000000",
			"00000000000000000000",
			"00000000000000000000",
			"00000100000000001000",
			"00000000000000000000",
			"00000000000000000000"
		],
		[
			"00000000111110000000",
			"00000000000000000000",
			"00000000000000000000",
			"00000000000000000000",
			"00000000000000000000",
			"00000000000000000000",
			"00000000000000000000",
			"00000000000000000000",
			"00000000000000000000",
			"00000000000000000000",
			"00000000000000000000",
			"00000000000000000000",
			"00000000000000000000",
			"00000000000000000000",
			"00000000000000000000",
			"00000000000000000000",
			"00000000000000000000",
			"00000000000000000000",
			"00000000000000000000",
			"00000000000000000000"
		]
	]
}