{
	"startPosition" : {
		"x" : 16,
		"y" : 1,
		"z" : 16
	},

	"goalPosition" : {
		"x" : 3,
		"y" : 1,
		"z" : 3
	},
	
	"world" : [
		[
			"00000000000000000000",
			"00000000000000000000",
			"00111111111111111100",
			"00111111111111111100",
			"00111111111111111100",
			"00111111111111111100",
			"00111111111111111100",
			"00111111111111111100",
			"00111111111111111100",
			"00111111111111111100",
			"00111111111111111100",
			"00111111111111111100",
			"00111111111111111100",
			"00111111111111111100",
			"00111111111111111100",
			"00111111111111111100",
			"00111111111111111100",
			"00111111111111111100",
			"00000000000000000000",
			"00000000000000000000"
		],
		[
			"00000000000000000000",
			"00000000000000000000",
			"00111111111111111100",
			"00100000000000000100",
			"00111111111111000100",
			"00100000000000000100",
			"00100011111111111100",
			"00100000000000000100",
			"00111111111111000100",
			"00100000000000000100",
			"00100011111111111100",
			"00100000000000000100",
			"00100011111111111100",
			"00100000000000000100",
			"00100000000000000100",
			"00100011111111111100",
			"00100000000000000100",
			"00111111111111111100",
			"00000000000000000000",
			"00000000000000000000"
		],
		[
			"00000000000000000000",
			"00000000000000000000",
			"00000000000000000000",
			"00000000000000000000",
			"00000000000000000000",
			"00000000000000000000",
			"00000000000000000000",
			"00000000000000000000",
			"00000000000000000000",
			"00000000000100000000",
			"00000000000000000000",
			"00000000000000000000",
			"00000000000000000000",
			"00000000001000000000",
			"00000000000000000000",
			"00000000000000000000",
			"00000000000000000000",
			"00000100000000001000",
			"00000000000000000000",
			"00000000000000000000"
		],
		[
			"00000000111110000000",
			"00000000000000000000",
			"00000000000000000000",
			"00000000000000000000",
			"00000000000000000000",
			"00000000000000000000",
			"00000000000000000000",
			"00000000000000000000",
			"00000000000000000000",
			"00000000000000000000",
			"00000000000000000000",
			"00000000000000000000",
			"00000000000000000000",
			"00000000000000000000",
			"00000000000000000000",
			"00000000000000000000",
			"00000000000000000000",
			"00000000000000000000",
			"00000000000000000000",
			"00000000000000000000"
		]
	]
}