{
	"world" : [
		[
			"00000000000000000000",
			"00000000000000000000",
			"00111100000000111100",
			"00111100000000111100",
			"00111100000000111100",
			"00111100000000111100",
			"00111100000000111100",
			"00111100000000111100",
			"00111100000000111100",
			"00111100000000111100",
			"00111100000000111100",
			"00111100000000111100",
			"00111100000000111100",
			"00111100000000111100",
			"00111100000000111100",
			"00111100000000111100",
			"00111100000000111100",
			"00111100000000111100",
			"00000000000000000000",
			"00000000000000000000"
		],
		[
			"00000000000000000000",
			"00000000000000000000",
			"00111100000000111100",
			"00111100000000111100",
			"00111111111111111100",
			"00111111111111111100",
			"00111100000000111100",
			"00111100000000111100",
			"00000000000000000000",
			"00000000000000000000",
			"00000000000000000000",
			"00000000000000000000",
			"00000000000000000000",
			"000p0000000000000000",
			"00000000000000000000",
			"00000000000000000000",
			"00000000000000000000",
			"0000000000000000g000",
			"00000000000000000000",
			"00000000000000000000"
		],
		[
			"00000000000000000000",
			"00000000000000000000",
			"00000000000000000000",
			"00000000000000000000",
			"00000011111111000000",
			"00000011111111000000",
			"00000000000000000000",
			"00000000000000000000",
			"00000000000000000000",
			"00000000000000000000",
			"00000000000000000000",
			"00000000000000000000",
			"00000000000000000000",
			"00000000000000000000",
			"00000000000000000000",
			"00000000000000000000",
			"00000000000000000000",
			"00000000000000000000",
			"00000000000000000000",
			"00000000000000000000"
		],
		[
			"00000000000000000000",
			"00000000000000000000",
			"00000000000000000000",
			"00000000000000000000",
			"00000000000000000000",
			"00000000000000000000",
			"00000000000000000000",
			"00000000000000000000",
			"00000000000000000000",
			"00000000000000000000",
			"00000000000000000000",
			"00000000000000000000",
			"00000000000000000000",
			"00000000000000000000",
			"00000000000000000000",
			"00000000000000000000",
			"00000000000000000000",
			"00000000000000000000",
			"00000000000000000000",
			"00000000000000000000"
		]
	]
}